111111111111111
1C00000000000C1
100010000010001
100001000100001
10X011111110X01
100110111011001
101111111111101
101C1111111C101
1010100E0010101
10000110110X001
1P0000000000001
111111111111111