11111111111111111
1C0000X00000000E1
11100111111100111
10000000CX0000001
11100111111100111
1C00000X000000C01
11100111111100111
100000X0C00000001
11100111111100111
10P000000000000C1
11111111111111111