11111111111111111
1C0000000000000E1
11100111111100111
10000000C00000001
11100111111100111
1C000000000000C01
11100111111100111
10000000C00000001
11100111111100111
10P000000000000C1
11111111111111111