11111
1E0C1
10001
1C0P1
11111
