11111111111
10000000001
10010110101
10010000101
1P0000E0001
11111011111
1C0000000C1
100101101C1
10010000101
1C000100001
11111111111