11111111111111111111
1E000000000000000001
11111111111111111101
1C000000000000000101
10111111111111110101
10100000000000010101
101C1111111111010101
10101C00000001010101
10101011111101010101
10101010000101010101
1010101011P001010101
10101010111111010101
10101010000000010101
10101011111111110101
10100000000000000101
10111111111111111101
10000000000000000001
11111111111111111111