1111111111111111111
100C000000000000C01
1011111010010111101
100010001001X100101
100010X010100100101
10001C001E100100101
1011111011000111101
10000X00000C00PC001
1111111111111111111