1111111111111111
1C000000000001C1
1110100011110101
1000100000000001
1001101111111111
1P001000000000E1
1111111111111111