1111111111111111111
100C000000000000C01
1011111010010111101
1000100010010100101
1000100010100100101
10001C001E100100101
1011111011000111101
10000000000C00PC001
1111111111111111111