11111111111111
1C01C0000000C1
10011111001001
10E00000001001
10000111111001
1P001100000001
11111111111111