11111111111
1C0000000C1
100101101C1
10010000101
1P0001E0001
11111111111