11111111111
1C0000000C1
1X0101101C1
1001X000101
1P0001E0001
11111111111