1111111
10C00P1
1110111
10001E1
1111111