11111
1E001
11101
10001
10111
10001
111C1
1P001
11111